
A. Tính Năng Cộng Đồng:
- Home Page: chứa các thông tin giới thiệu về trang web, mặt hàng đang buôn bán, sản phẩm nổi bật
- Blog List: danh sách một số khách hàng nỗi bật, bài viết , bình luận nổi bật của khách hàng 
- Customer Care:  hiển thị các mặt hàng thương mại điện tử website liên kết
- Login / Logout: trên trang chủ người dùng đăng nhập hoặc đăng xuất tài khoản khỏi website, dựa vào chức vụ sẽ phân quyền người dùng vào trang 1 trong 2 trang (Seller Page or Customer Page)
- Register: cho phép người dùng đăng ký tài khoản của mình với quyền mặc định là khách hàng (US) hoặc lấy lại mật khẩu 
- By Phone: cho phép người dùng đăng ký tài khoản và đăng nhập bằng số điện thoại
- By Google: cho phép người dùng đăng ký tài khoản và đăng nhập bằng tài khoản google
B. Tính Năng Quản Lý:
+ Manager Page: hiển thị khung giao diện chung của trang web và chỉ có nút bấm chức năng dành cho quản lý
- Approval Request: hiển thị danh sách customer đăng ký trở thành người bán, cho phép duyệt hoặc từ chối bằng cách thay đổi role, ID và thông báo đến tài khoản tương ứng
- Show Most Product Sell: hiển thị danh sách sản phẩm có số điểm đánh giá tổng từ 4 đến 5
- Show Seller List:  hiển thị danh sách toàn bộ người bán hàng (SE) cho phép xóa , treo người bán bên cạnh đó cho phép quản lý có thể tự tạo tài khoản và phân quyền 1 trong 2 chức vụ tùy ý
- Show Customer Report:  hiển thị danh sách sản phẩm bị báo cáo với thông tin người bán sản phẩm đi kèm để đưa ra quyết định ở chức năng “Show Seller List” đồng thời thông báo đến người dùng nếu đã giải quyết
- Check Product Application: hiển thị danh sách hàng mới đươc seller đăng ký cho phép duyệt hoặc từ chối
C. Tính Năng Người Bán:
- Seller Page: Hiện thi thông tin cơ bản của người bán cùng với các chức năng đi kèm
-Send Product Application: cho phép người bán tạo mới sản phẩm và thêm vào 1 danh sách hàng đăng ký và gửi cho quản lý chờ phê duyệt, ở mục chọn  loại hàng có chức năng cho người dùng tự tạo loại hàng mới
- Edit Personal Profile: cho phép người bán tự chỉnh sửa thông tin cơ bản của mình trừ ID
- Show Customer Orders Detail List: hiển thị danh sách yêu cầu chi tiết của khách hàng theo trang thái (status) tùy chọn và cho phép người bán chuyển trạng thái từ đang chờ sử lý thành đang sử lý hoặc đã hoàn thành 
- Selling For Seller Page: ở trang người bán, người bán có thể vào trang bán hàng của mình nơi hiển thị thông tin những mặt hàng có mã người bán(sellerID) là của mình đồng thời có các chức năng liên trực tiếp trên sản phẩm
- Edit Product Selling For Seller: cho phép người bán có các chưng năng liên quan trên sản phẩm bao gồm xóa , gỡ xuống, chỉnh số lượng, thêm vào, thay đổi thông tin( tên, mã, chi tiết, ảnh, loại), thay đổi giá
D. Tính Năng Khách Hàng:
+ Customer Page: hiển thị thông tin cơ bản của khách hàng và các chức năng liên quan
+ Edit Personal Profile: khách hàng có thể chỉnh sửa tùy ý thông tin cá nhân của mình trừ ID , đổi mật khẩu trực tiếp trong trang của mình.
- Request Become To A Seller: cho phép khách hàng gửi 1 đơn yêu cầu với lý do mục đích nào đó và muốn trở thành một người bán hàng
- Selling For Customer Page: từ trang khách hàng , khách hàng có thể qua trang bán hàng nơi hiển thị toàn bộ sản phẩm của những người bán vào có các chức năng liên quan trực tiếp trên sản phẩm
- Top Recommend Product For Customer: trên trang bán hàng khách hàng có 1 nút ấn hoặc 1 thanh giao diện riêng nơi hiện thị những sản phẩm bán chạy với tổng số điểm đánh giá từ 4-5
- Order Product For Customer: với mỗi sản phẩm khách hàng sẽ có chức năng thêm vào giỏ hàng hoặc mong ước với số lượng tùy ý mặc định là 1
- Report Product For Customer: với mỗi sản phẩm khác hàng sẽ có 1 nút báo cáo kế bên nới khách hàng đăng những đánh giá tiêu cực hoặc phản ảnh về người bán sản phẩm gửi về quản lý
-  Cart: từ trang người bán hoặc trang bán hàng , khách hàng có thể vào trực tiếp vào giỏ hàng.
Giỏ hàng hiển thị thông tin mặt hàng đã được thêm vào với các chức năng tương ứng 
- Edit Product Buying: Khách hàng có thể tùy chỉnh lại số lượng lại một lần nữa trước khi thanh toán
- Wish List: cho phép khách hàng thêm sản phẩm nào đó có trong giỏ hàng hoặc từ trang bán hàng vào mục mong muốn , mục này sẽ lưu giữ sản phẩm khách hàng muốn mua nhưng chưa đủ điều kiện hoặc sẽ mua vào lúc khác và chức năng giống một giỏ hàng thông thường ( khác sản phẩm khi được thêm vào Wish List sẽ tự lưu và hiển thị vào lần đăng nhập sau )
- Cumulative Point / Discount: với mỗi sản phẩm mua khách hàng có thể tích lũy điểm thưởng khi đạt một mốc nào đó khách hàng có thể chọn sử điểm tích lũy để giảm giá theo phần trăm hoặc trừ trực tiếp vào tiền thanh toán ( khi khách hàng chọn sử dụng điểm tích lũy lần mua đó sẽ không tính vào điểm tích lũy)
- Check Out: thanh toán sản phẩm và xóa giỏ hàng/mong ước
      + Recapcha: khách hàng phải nhập capcha trước khi thanh toán
      + Comment Rating: sau khi thanh toán khách hàng sẽ được hỏi có muốn bình luận hay đánh giá số điểm cho mặt hàng hay không ( nếu là 1 sản phẩm bình luận hoặc chấm điểm sẽ lưu trực tiếp vào DB , với nhiều sản phẩm sẽ cho khách hàng chọn sản phẩm muốn đánh giá)
     + Online: khách hàng thánh toán online và chuyển trang thái “payment”(orderDetail) thành 2
     + When get Product: thanh toán sau khi nhận hàng ( coming soon)


